rno,name,m1,m2,m3,total_marks
1,John,40,46,33,119
2,Emma,35,41,47,123
3,David,45,36,41,122
4,Sophia,38,50,40,128
5,Michael,42,43,36,121
6,Olivia,48,39,43,130
7,James,50,47,45,142
8,Isabella,30,42,49,121
9,William,44,38,35,117
10,Mia,39,45,37,121
